0,4,16
1111111111111111
1111111111111111
1111111111111111
0000000000000000
0000000000000002
0000000000000000
1111111111111111
1111111111111111
1111111111111111
