15,4,19
0000000000001111
0201000000000001
0111111111001111
0111101000000000
0111101111111110
0111101111111110
0111100000000000
0111101111111110
0000000000000000
