1,1,21
0000001010000000
0000001010000000
0000001010000000
0000001010000000
0000001010000000
0000001010000000
0000004040000000
0000003030000002
0000001010000000
