15,7,26
2011161111111111
0077000000000000
1111010000000000
1111010000000000
1100010000000000
1101110000000000
1101111111111101
1100000000000000
1111111111111111
