15,4,19
0011111111111000
0031313131313000
0004040404040000
0011111111111000
2011111111111000
0011111111111000
0030303030303000
0014141414141000
0011111111111000
