0,0,19
0000000110000011
0000000110000001
0000000110000000
0000050500500000
0000000000000002
0000000110000000
0000000110000000
1000000110000001
1100000110000011
