8,4,300000000000
0300030030030030
0303030000033030
0303030030030330
0030300030030030
0000000000000000
0000000000000000
0000000000000000
0000000000000000
0000000000000000
