8,4,500000000000
0500050050050050
0505050000055050
0505050050050550
0050500050050050
0000000000000000
0000000000000000
0000000000000000
0000000000000000
0000000000000000
